1111111111
1P000000C1
1011111001
1010001001
1010001001
10100010E1
1111111111
