1111111111111111111111111111
1P000000C1111111111111111111
1011111001111111111111111111
1010001001111111111111111111
1010001011111111111111111111
10100010E1111111111111111111
1111111111111111111111111111