11111111111111111111111111111111
1PC01111111111111111111111111111
1E001111111111111111111111111111
11111111111111111111111111111111