11111111111111111111111111
1P000000000000000000000001
11111111111111111111110111
10000000000000000000000001
10111111111111111111111111
10100000000000000000000011
10100000000000000000000001
10100000000000000000000011
10111111111111111111111111
10100000000000000000000001
10100000000000000000000001
10001111111111111111111101
11111111111111111110111101
1CCCCCCPCCCCCCCCCCCCCCCCC1
1E000000000000000000000001
11111111111111111111111111