1111111111
10000000E1
100C000111
100P000001
1111111111