11111111
11E11111
11C000P1
11111111
11C11111
11111111