1111111
1P00001
1C11111
1E11111
1111111